3.00, 4, 0.0, 0.0, 0.0, 161, 85, 76
6.01, 4, 0.0, 0.0, 0.0, 156, 78, 78
9.01, 4, 0.0, 0.0, 0.0, 161, 81, 80
12.01, 4, 0.0, 0.0, 0.0, 162, 81, 81
15.01, 4, 0.0, 0.0, 0.0, 156, 80, 76
18.02, 4, 0.0, 0.2, 0.2, 118, 60, 58
21.03, 4, 0.0, 0.2, 0.2, 117, 58, 59
24.03, 4, 0.0, 0.2, 0.2, 118, 60, 58
27.04, 4, 0.0, 0.2, 0.2, 118, 59, 59
30.04, 4, 0.0, 0.2, 0.2, 118, 60, 58
33.04, 4, 0.0, 0.4, 0.4, 110, 55, 55
36.05, 4, 0.0, 0.4, 0.4, 110, 55, 55
39.05, 4, 0.0, 0.4, 0.4, 111, 55, 56
42.06, 4, 0.0, 0.4, 0.4, 111, 55, 56
45.06, 4, 0.0, 0.4, 0.4, 110, 55, 55
48.07, 4, 0.0, 0.5, 0.5, 121, 60, 61
51.07, 4, 0.0, 0.5, 0.5, 122, 61, 61
54.07, 4, 0.0, 0.5, 0.5, 120, 60, 60
57.08, 4, 0.0, 0.5, 0.5, 120, 60, 60
60.08, 4, 0.0, 0.5, 0.5, 120, 60, 60
63.08, 4, 0.0, 0.6, 0.6, 140, 70, 70
66.09, 4, 0.0, 0.6, 0.6, 140, 70, 70
69.09, 4, 0.0, 0.6, 0.6, 137, 69, 68
72.09, 4, 0.0, 0.6, 0.6, 135, 67, 68
75.10, 4, 0.0, 0.6, 0.6, 85, 43, 42
78.10, 4, 0.0, 0.8, 0.8, 109, 54, 55
81.10, 4, 0.0, 0.8, 0.8, 109, 53, 56
84.11, 4, 0.0, 0.8, 0.8, 108, 54, 54
87.11, 4, 0.0, 0.8, 0.8, 109, 54, 55
90.12, 4, 0.0, 0.8, 0.8, 111, 55, 56
93.12, 4, 0.0, 1.0, 1.0, 480, 240, 240
96.12, 4, 0.0, 1.0, 1.0, 478, 240, 238
99.12, 4, 0.0, 1.0, 1.0, 484, 241, 243
102.13, 4, 0.0, 1.0, 1.0, 477, 238, 239
105.13, 4, 0.0, 1.0, 1.0, 467, 235, 232
108.13, 4, 0.5, 0.0, 0.0, 84, 42, 42
111.14, 4, 0.5, 0.0, 0.0, 84, 42, 42
114.15, 4, 0.5, 0.0, 0.0, 84, 42, 42
117.16, 4, 0.5, 0.0, 0.0, 84, 42, 42
120.16, 4, 0.5, 0.0, 0.0, 84, 42, 42
123.18, 4, 0.5, 0.2, 0.2, 68, 34, 34
126.19, 4, 0.5, 0.2, 0.2, 69, 35, 34
129.20, 4, 0.5, 0.2, 0.2, 69, 34, 35
132.21, 4, 0.5, 0.2, 0.2, 68, 34, 34
135.22, 4, 0.5, 0.2, 0.2, 66, 33, 33
138.23, 4, 0.5, 0.4, 0.4, 64, 32, 32
141.24, 4, 0.5, 0.4, 0.4, 64, 32, 32
144.25, 4, 0.5, 0.4, 0.4, 64, 32, 32
147.26, 4, 0.5, 0.4, 0.4, 64, 32, 32
150.27, 4, 0.5, 0.4, 0.4, 62, 31, 31
153.27, 4, 0.5, 0.5, 0.5, 66, 33, 33
156.28, 4, 0.5, 0.5, 0.5, 66, 33, 33
159.29, 4, 0.5, 0.5, 0.5, 63, 32, 31
162.30, 4, 0.5, 0.5, 0.5, 67, 34, 33
165.31, 4, 0.5, 0.5, 0.5, 65, 33, 32
168.31, 4, 0.5, 0.6, 0.6, 69, 34, 35
171.32, 4, 0.5, 0.6, 0.6, 71, 36, 35
174.33, 4, 0.5, 0.6, 0.6, 69, 34, 35
177.33, 4, 0.5, 0.6, 0.6, 70, 35, 35
180.33, 4, 0.5, 0.6, 0.6, 68, 34, 34
183.34, 4, 0.5, 0.8, 0.8, 89, 44, 45
186.34, 4, 0.5, 0.8, 0.8, 90, 45, 45
189.35, 4, 0.5, 0.8, 0.8, 87, 44, 43
192.36, 4, 0.5, 0.8, 0.8, 91, 46, 45
195.37, 4, 0.5, 0.8, 0.8, 90, 45, 45
198.38, 4, 0.5, 1.0, 1.0, 290, 145, 145
201.38, 4, 0.5, 1.0, 1.0, 285, 142, 143
204.38, 4, 0.5, 1.0, 1.0, 285, 143, 142
207.38, 4, 0.5, 1.0, 1.0, 288, 144, 144
210.38, 4, 0.5, 1.0, 1.0, 286, 143, 143
213.39, 4, 1.0, 0.0, 0.0, 90, 45, 45
216.39, 4, 1.0, 0.0, 0.0, 92, 46, 46
219.40, 4, 1.0, 0.0, 0.0, 92, 46, 46
222.41, 4, 1.0, 0.0, 0.0, 92, 46, 46
225.42, 4, 1.0, 0.0, 0.0, 92, 46, 46
228.43, 4, 1.0, 0.2, 0.2, 69, 34, 35
231.44, 4, 1.0, 0.2, 0.2, 71, 36, 35
234.45, 4, 1.0, 0.2, 0.2, 68, 34, 34
237.46, 4, 1.0, 0.2, 0.2, 68, 34, 34
240.47, 4, 1.0, 0.2, 0.2, 68, 34, 34
243.48, 4, 1.0, 0.4, 0.4, 64, 32, 32
246.49, 4, 1.0, 0.4, 0.4, 63, 31, 32
249.50, 4, 1.0, 0.4, 0.4, 63, 32, 31
252.51, 4, 1.0, 0.4, 0.4, 64, 32, 32
255.51, 4, 1.0, 0.4, 0.4, 64, 32, 32
258.52, 4, 1.0, 0.5, 0.5, 63, 32, 31
261.52, 4, 1.0, 0.5, 0.5, 63, 32, 31
264.54, 4, 1.0, 0.5, 0.5, 64, 32, 32
267.55, 4, 1.0, 0.5, 0.5, 66, 33, 33
270.55, 4, 1.0, 0.5, 0.5, 65, 32, 33
273.56, 4, 1.0, 0.6, 0.6, 68, 34, 34
276.56, 4, 1.0, 0.6, 0.6, 67, 33, 34
279.57, 4, 1.0, 0.6, 0.6, 68, 34, 34
282.57, 4, 1.0, 0.6, 0.6, 68, 34, 34
285.58, 4, 1.0, 0.6, 0.6, 67, 34, 33
288.59, 4, 1.0, 0.8, 0.8, 81, 40, 41
291.59, 4, 1.0, 0.8, 0.8, 81, 41, 40
294.59, 4, 1.0, 0.8, 0.8, 82, 41, 41
297.60, 4, 1.0, 0.8, 0.8, 84, 42, 42
300.60, 4, 1.0, 0.8, 0.8, 84, 42, 42
303.60, 4, 1.0, 1.0, 1.0, 192, 96, 96
306.60, 4, 1.0, 1.0, 1.0, 188, 94, 94
309.61, 4, 1.0, 1.0, 1.0, 190, 95, 95
312.61, 4, 1.0, 1.0, 1.0, 189, 95, 94
315.61, 4, 1.0, 1.0, 1.0, 189, 94, 95
318.62, 8, 0.0, 0.0, 0.0, 255, 136, 119
321.62, 8, 0.0, 0.0, 0.0, 254, 125, 129
324.63, 8, 0.0, 0.0, 0.0, 257, 128, 129
327.63, 8, 0.0, 0.0, 0.0, 256, 130, 126
330.63, 8, 0.0, 0.0, 0.0, 260, 126, 134
333.63, 8, 0.0, 0.2, 0.2, 133, 65, 68
336.64, 8, 0.0, 0.2, 0.2, 139, 68, 71
339.65, 8, 0.0, 0.2, 0.2, 131, 66, 65
342.66, 8, 0.0, 0.2, 0.2, 136, 65, 71
345.66, 8, 0.0, 0.2, 0.2, 136, 71, 65
348.68, 8, 0.0, 0.4, 0.4, 105, 53, 52
351.85, 8, 0.0, 0.4, 0.4, 98, 51, 47
354.87, 8, 0.0, 0.4, 0.4, 101, 49, 52
357.88, 8, 0.0, 0.4, 0.4, 105, 53, 52
360.89, 8, 0.0, 0.4, 0.4, 99, 48, 51
363.93, 8, 0.0, 0.5, 0.5, 105, 53, 52
366.94, 8, 0.0, 0.5, 0.5, 102, 51, 51
369.95, 8, 0.0, 0.5, 0.5, 101, 50, 51
372.97, 8, 0.0, 0.5, 0.5, 102, 52, 50
375.98, 8, 0.0, 0.5, 0.5, 104, 52, 52
379.00, 8, 0.0, 0.6, 0.6, 105, 53, 52
382.01, 8, 0.0, 0.6, 0.6, 108, 54, 54
385.01, 8, 0.0, 0.6, 0.6, 107, 54, 53
388.02, 8, 0.0, 0.6, 0.6, 107, 53, 54
391.02, 8, 0.0, 0.6, 0.6, 106, 53, 53
394.03, 8, 0.0, 0.8, 0.8, 138, 69, 69
397.06, 8, 0.0, 0.8, 0.8, 130, 64, 66
400.07, 8, 0.0, 0.8, 0.8, 137, 68, 69
403.07, 8, 0.0, 0.8, 0.8, 134, 66, 68
406.09, 8, 0.0, 0.8, 0.8, 131, 65, 66
409.09, 8, 0.0, 1.0, 1.0, 647, 323, 324
412.09, 8, 0.0, 1.0, 1.0, 636, 318, 318
415.10, 8, 0.0, 1.0, 1.0, 643, 321, 322
418.10, 8, 0.0, 1.0, 1.0, 637, 319, 318
421.10, 8, 0.0, 1.0, 1.0, 641, 321, 320
424.11, 8, 0.5, 0.0, 0.0, 157, 79, 78
427.12, 8, 0.5, 0.0, 0.0, 160, 80, 80
430.12, 8, 0.5, 0.0, 0.0, 159, 80, 79
433.13, 8, 0.5, 0.0, 0.0, 160, 80, 80
436.13, 8, 0.5, 0.0, 0.0, 159, 80, 79
439.14, 8, 0.5, 0.2, 0.2, 100, 50, 50
442.15, 8, 0.5, 0.2, 0.2, 105, 52, 53
445.16, 8, 0.5, 0.2, 0.2, 105, 53, 52
448.17, 8, 0.5, 0.2, 0.2, 99, 50, 49
451.18, 8, 0.5, 0.2, 0.2, 106, 53, 53
454.19, 8, 0.5, 0.4, 0.4, 92, 45, 47
457.20, 8, 0.5, 0.4, 0.4, 94, 47, 47
460.21, 8, 0.5, 0.4, 0.4, 92, 46, 46
463.22, 8, 0.5, 0.4, 0.4, 96, 48, 48
466.23, 8, 0.5, 0.4, 0.4, 88, 44, 44
469.25, 8, 0.5, 0.5, 0.5, 93, 46, 47
472.25, 8, 0.5, 0.5, 0.5, 96, 48, 48
475.26, 8, 0.5, 0.5, 0.5, 91, 45, 46
478.26, 8, 0.5, 0.5, 0.5, 92, 46, 46
481.32, 8, 0.5, 0.5, 0.5, 96, 48, 48
484.34, 8, 0.5, 0.6, 0.6, 100, 50, 50
487.35, 8, 0.5, 0.6, 0.6, 98, 49, 49
490.35, 8, 0.5, 0.6, 0.6, 100, 50, 50
493.36, 8, 0.5, 0.6, 0.6, 101, 50, 51
496.38, 8, 0.5, 0.6, 0.6, 96, 48, 48
499.38, 8, 0.5, 0.8, 0.8, 119, 59, 60
502.39, 8, 0.5, 0.8, 0.8, 123, 61, 62
505.40, 8, 0.5, 0.8, 0.8, 118, 58, 60
508.41, 8, 0.5, 0.8, 0.8, 123, 62, 61
511.42, 8, 0.5, 0.8, 0.8, 121, 60, 61
514.42, 8, 0.5, 1.0, 1.0, 379, 189, 190
517.43, 8, 0.5, 1.0, 1.0, 372, 186, 186
520.43, 8, 0.5, 1.0, 1.0, 378, 189, 189
523.43, 8, 0.5, 1.0, 1.0, 377, 188, 189
526.43, 8, 0.5, 1.0, 1.0, 372, 186, 186
529.44, 8, 1.0, 0.0, 0.0, 168, 84, 84
532.45, 8, 1.0, 0.0, 0.0, 168, 84, 84
535.45, 8, 1.0, 0.0, 0.0, 168, 84, 84
538.46, 8, 1.0, 0.0, 0.0, 168, 84, 84
541.47, 8, 1.0, 0.0, 0.0, 168, 84, 84
544.48, 8, 1.0, 0.2, 0.2, 98, 49, 49
547.48, 8, 1.0, 0.2, 0.2, 109, 54, 55
550.49, 8, 1.0, 0.2, 0.2, 106, 53, 53
553.50, 8, 1.0, 0.2, 0.2, 106, 53, 53
556.50, 8, 1.0, 0.2, 0.2, 108, 54, 54
559.52, 8, 1.0, 0.4, 0.4, 89, 44, 45
562.54, 8, 1.0, 0.4, 0.4, 96, 48, 48
565.55, 8, 1.0, 0.4, 0.4, 93, 47, 46
568.57, 8, 1.0, 0.4, 0.4, 92, 46, 46
571.58, 8, 1.0, 0.4, 0.4, 95, 47, 48
574.59, 8, 1.0, 0.5, 0.5, 90, 45, 45
577.60, 8, 1.0, 0.5, 0.5, 94, 47, 47
580.61, 8, 1.0, 0.5, 0.5, 94, 46, 48
583.62, 8, 1.0, 0.5, 0.5, 93, 47, 46
586.64, 8, 1.0, 0.5, 0.5, 95, 48, 47
589.65, 8, 1.0, 0.6, 0.6, 91, 46, 45
592.66, 8, 1.0, 0.6, 0.6, 93, 46, 47
595.67, 8, 1.0, 0.6, 0.6, 96, 49, 47
598.68, 8, 1.0, 0.6, 0.6, 97, 49, 48
601.68, 8, 1.0, 0.6, 0.6, 96, 47, 49
604.69, 8, 1.0, 0.8, 0.8, 116, 58, 58
607.69, 8, 1.0, 0.8, 0.8, 115, 58, 57
610.70, 8, 1.0, 0.8, 0.8, 118, 59, 59
613.70, 8, 1.0, 0.8, 0.8, 115, 58, 57
616.71, 8, 1.0, 0.8, 0.8, 118, 59, 59
619.71, 8, 1.0, 1.0, 1.0, 295, 148, 147
622.72, 8, 1.0, 1.0, 1.0, 292, 146, 146
625.72, 8, 1.0, 1.0, 1.0, 288, 144, 144
628.72, 8, 1.0, 1.0, 1.0, 296, 148, 148
631.73, 8, 1.0, 1.0, 1.0, 298, 149, 149
634.75, 128, 0.0, 0.0, 0.0, 785, 380, 405
637.76, 128, 0.0, 0.0, 0.0, 766, 389, 377
640.77, 128, 0.0, 0.0, 0.0, 773, 391, 382
643.78, 128, 0.0, 0.0, 0.0, 785, 370, 415
646.81, 128, 0.0, 0.0, 0.0, 754, 379, 375
649.84, 128, 0.0, 0.2, 0.2, 391, 202, 189
652.87, 128, 0.0, 0.2, 0.2, 379, 186, 193
655.91, 128, 0.0, 0.2, 0.2, 392, 197, 195
658.96, 128, 0.0, 0.2, 0.2, 398, 201, 197
661.98, 128, 0.0, 0.2, 0.2, 400, 198, 202
665.00, 128, 0.0, 0.4, 0.4, 335, 169, 166
668.03, 128, 0.0, 0.4, 0.4, 343, 170, 173
671.05, 128, 0.0, 0.4, 0.4, 331, 165, 166
674.09, 128, 0.0, 0.4, 0.4, 346, 176, 170
677.13, 128, 0.0, 0.4, 0.4, 342, 170, 172
680.14, 128, 0.0, 0.5, 0.5, 344, 174, 170
683.19, 128, 0.0, 0.5, 0.5, 345, 173, 172
686.21, 128, 0.0, 0.5, 0.5, 334, 165, 169
689.22, 128, 0.0, 0.5, 0.5, 332, 166, 166
692.27, 128, 0.0, 0.5, 0.5, 357, 180, 177
695.30, 128, 0.0, 0.6, 0.6, 367, 182, 185
698.33, 128, 0.0, 0.6, 0.6, 366, 185, 181
701.37, 128, 0.0, 0.6, 0.6, 374, 189, 185
704.44, 128, 0.0, 0.6, 0.6, 379, 192, 187
707.48, 128, 0.0, 0.6, 0.6, 369, 185, 184
710.52, 128, 0.0, 0.8, 0.8, 476, 238, 238
713.55, 128, 0.0, 0.8, 0.8, 466, 236, 230
716.61, 128, 0.0, 0.8, 0.8, 470, 233, 237
719.68, 128, 0.0, 0.8, 0.8, 466, 230, 236
722.71, 128, 0.0, 0.8, 0.8, 467, 239, 228
725.74, 128, 0.0, 1.0, 1.0, 652, 326, 326
728.75, 128, 0.0, 1.0, 1.0, 630, 315, 315
731.77, 128, 0.0, 1.0, 1.0, 634, 318, 316
734.78, 128, 0.0, 1.0, 1.0, 622, 311, 311
737.81, 128, 0.0, 1.0, 1.0, 650, 325, 325
740.82, 128, 0.5, 0.0, 0.0, 632, 316, 316
743.85, 128, 0.5, 0.0, 0.0, 634, 317, 317
746.88, 128, 0.5, 0.0, 0.0, 635, 318, 317
749.91, 128, 0.5, 0.0, 0.0, 634, 317, 317
752.92, 128, 0.5, 0.0, 0.0, 632, 316, 316
755.95, 128, 0.5, 0.2, 0.2, 413, 206, 207
758.99, 128, 0.5, 0.2, 0.2, 378, 189, 189
762.01, 128, 0.5, 0.2, 0.2, 389, 194, 195
765.03, 128, 0.5, 0.2, 0.2, 371, 186, 185
768.08, 128, 0.5, 0.2, 0.2, 378, 189, 189
771.14, 128, 0.5, 0.4, 0.4, 334, 167, 167
774.24, 128, 0.5, 0.4, 0.4, 310, 153, 157
777.29, 128, 0.5, 0.4, 0.4, 343, 172, 171
780.34, 128, 0.5, 0.4, 0.4, 353, 176, 177
783.37, 128, 0.5, 0.4, 0.4, 334, 165, 169
786.43, 128, 0.5, 0.5, 0.5, 326, 163, 163
789.48, 128, 0.5, 0.5, 0.5, 333, 168, 165
792.49, 128, 0.5, 0.5, 0.5, 332, 166, 166
795.64, 128, 0.5, 0.5, 0.5, 346, 176, 170
798.67, 128, 0.5, 0.5, 0.5, 380, 190, 190
801.70, 128, 0.5, 0.6, 0.6, 351, 177, 174
804.76, 128, 0.5, 0.6, 0.6, 401, 200, 201
807.80, 128, 0.5, 0.6, 0.6, 366, 185, 181
810.84, 128, 0.5, 0.6, 0.6, 373, 188, 185
813.87, 128, 0.5, 0.6, 0.6, 343, 170, 173
816.90, 128, 0.5, 0.8, 0.8, 462, 224, 238
819.93, 128, 0.5, 0.8, 0.8, 442, 219, 223
822.97, 128, 0.5, 0.8, 0.8, 453, 226, 227
826.00, 128, 0.5, 0.8, 0.8, 444, 218, 226
829.03, 128, 0.5, 0.8, 0.8, 448, 214, 234
832.05, 128, 0.5, 1.0, 1.0, 612, 306, 306
835.07, 128, 0.5, 1.0, 1.0, 612, 306, 306
838.11, 128, 0.5, 1.0, 1.0, 608, 304, 304
841.12, 128, 0.5, 1.0, 1.0, 614, 307, 307
844.15, 128, 0.5, 1.0, 1.0, 610, 305, 305
847.18, 128, 1.0, 0.0, 0.0, 626, 313, 313
850.19, 128, 1.0, 0.0, 0.0, 632, 316, 316
853.23, 128, 1.0, 0.0, 0.0, 633, 317, 316
856.23, 128, 1.0, 0.0, 0.0, 632, 316, 316
859.27, 128, 1.0, 0.0, 0.0, 632, 315, 317
862.32, 128, 1.0, 0.2, 0.2, 372, 184, 188
865.34, 128, 1.0, 0.2, 0.2, 380, 190, 190
868.38, 128, 1.0, 0.2, 0.2, 358, 178, 180
871.42, 128, 1.0, 0.2, 0.2, 370, 185, 185
874.46, 128, 1.0, 0.2, 0.2, 320, 160, 160
877.51, 128, 1.0, 0.4, 0.4, 356, 176, 180
880.54, 128, 1.0, 0.4, 0.4, 326, 164, 162
883.59, 128, 1.0, 0.4, 0.4, 354, 178, 176
886.65, 128, 1.0, 0.4, 0.4, 304, 151, 153
889.69, 128, 1.0, 0.4, 0.4, 313, 157, 156
892.75, 128, 1.0, 0.5, 0.5, 311, 156, 155
895.81, 128, 1.0, 0.5, 0.5, 334, 167, 167
898.86, 128, 1.0, 0.5, 0.5, 302, 151, 151
901.87, 128, 1.0, 0.5, 0.5, 324, 162, 162
904.95, 128, 1.0, 0.5, 0.5, 329, 166, 163
908.01, 128, 1.0, 0.6, 0.6, 359, 179, 180
911.07, 128, 1.0, 0.6, 0.6, 352, 176, 176
914.08, 128, 1.0, 0.6, 0.6, 320, 158, 162
917.10, 128, 1.0, 0.6, 0.6, 339, 170, 169
920.16, 128, 1.0, 0.6, 0.6, 332, 165, 167
923.18, 128, 1.0, 0.8, 0.8, 450, 223, 227
926.22, 128, 1.0, 0.8, 0.8, 458, 228, 230
929.26, 128, 1.0, 0.8, 0.8, 445, 218, 227
932.26, 128, 1.0, 0.8, 0.8, 456, 224, 232
935.31, 128, 1.0, 0.8, 0.8, 440, 219, 221
938.33, 128, 1.0, 1.0, 1.0, 594, 297, 297
941.35, 128, 1.0, 1.0, 1.0, 588, 294, 294
944.37, 128, 1.0, 1.0, 1.0, 586, 293, 293
947.37, 128, 1.0, 1.0, 1.0, 598, 299, 299
950.41, 128, 1.0, 1.0, 1.0, 592, 296, 296
953.47, 256, 0.0, 0.0, 0.0, 804, 393, 411
956.53, 256, 0.0, 0.0, 0.0, 785, 399, 386
959.58, 256, 0.0, 0.0, 0.0, 799, 389, 410
962.63, 256, 0.0, 0.0, 0.0, 780, 379, 401
965.73, 256, 0.0, 0.0, 0.0, 782, 379, 403
968.81, 256, 0.0, 0.2, 0.2, 542, 267, 275
971.85, 256, 0.0, 0.2, 0.2, 561, 282, 279
974.92, 256, 0.0, 0.2, 0.2, 539, 271, 268
977.97, 256, 0.0, 0.2, 0.2, 568, 281, 287
980.99, 256, 0.0, 0.2, 0.2, 562, 273, 289
984.09, 256, 0.0, 0.4, 0.4, 498, 250, 248
987.12, 256, 0.0, 0.4, 0.4, 512, 257, 255
990.14, 256, 0.0, 0.4, 0.4, 504, 248, 256
993.20, 256, 0.0, 0.4, 0.4, 502, 253, 249
996.23, 256, 0.0, 0.4, 0.4, 511, 256, 255
999.29, 256, 0.0, 0.5, 0.5, 499, 253, 246
1002.36, 256, 0.0, 0.5, 0.5, 509, 256, 253
1005.39, 256, 0.0, 0.5, 0.5, 503, 248, 255
1008.45, 256, 0.0, 0.5, 0.5, 499, 253, 246
1011.56, 256, 0.0, 0.5, 0.5, 511, 254, 257
1014.60, 256, 0.0, 0.6, 0.6, 511, 256, 255
1017.76, 256, 0.0, 0.6, 0.6, 491, 245, 246
1020.85, 256, 0.0, 0.6, 0.6, 518, 259, 259
1023.86, 256, 0.0, 0.6, 0.6, 498, 249, 249
1026.89, 256, 0.0, 0.6, 0.6, 535, 272, 263
1029.96, 256, 0.0, 0.8, 0.8, 583, 285, 298
1033.02, 256, 0.0, 0.8, 0.8, 551, 282, 269
1036.09, 256, 0.0, 0.8, 0.8, 573, 288, 285
1039.20, 256, 0.0, 0.8, 0.8, 573, 289, 284
1042.24, 256, 0.0, 0.8, 0.8, 594, 298, 296
1045.25, 256, 0.0, 1.0, 1.0, 646, 323, 323
1048.28, 256, 0.0, 1.0, 1.0, 626, 313, 313
1051.32, 256, 0.0, 1.0, 1.0, 658, 329, 329
1054.36, 256, 0.0, 1.0, 1.0, 656, 328, 328
1057.44, 256, 0.0, 1.0, 1.0, 650, 325, 325
1060.48, 256, 0.5, 0.0, 0.0, 1034, 517, 517
1063.50, 256, 0.5, 0.0, 0.0, 1044, 522, 522
1066.51, 256, 0.5, 0.0, 0.0, 1046, 523, 523
1069.52, 256, 0.5, 0.0, 0.0, 1044, 522, 522
1072.53, 256, 0.5, 0.0, 0.0, 1048, 524, 524
1075.56, 256, 0.5, 0.2, 0.2, 595, 296, 299
1078.63, 256, 0.5, 0.2, 0.2, 588, 293, 295
1081.69, 256, 0.5, 0.2, 0.2, 590, 296, 294
1084.75, 256, 0.5, 0.2, 0.2, 589, 294, 295
1087.77, 256, 0.5, 0.2, 0.2, 512, 256, 256
1090.82, 256, 0.5, 0.4, 0.4, 510, 254, 256
1093.85, 256, 0.5, 0.4, 0.4, 504, 256, 248
1096.93, 256, 0.5, 0.4, 0.4, 478, 243, 235
1100.01, 256, 0.5, 0.4, 0.4, 481, 238, 243
1103.15, 256, 0.5, 0.4, 0.4, 495, 246, 249
1106.19, 256, 0.5, 0.5, 0.5, 544, 271, 273
1109.28, 256, 0.5, 0.5, 0.5, 501, 250, 251
1112.30, 256, 0.5, 0.5, 0.5, 497, 249, 248
1115.33, 256, 0.5, 0.5, 0.5, 494, 246, 248
1118.38, 256, 0.5, 0.5, 0.5, 501, 254, 247
1121.46, 256, 0.5, 0.6, 0.6, 519, 252, 267
1124.51, 256, 0.5, 0.6, 0.6, 510, 256, 254
1127.59, 256, 0.5, 0.6, 0.6, 506, 252, 254
1130.61, 256, 0.5, 0.6, 0.6, 505, 256, 249
1133.66, 256, 0.5, 0.6, 0.6, 531, 269, 262
1136.68, 256, 0.5, 0.8, 0.8, 565, 282, 283
1139.72, 256, 0.5, 0.8, 0.8, 560, 281, 279
1142.77, 256, 0.5, 0.8, 0.8, 559, 273, 286
1145.85, 256, 0.5, 0.8, 0.8, 568, 292, 276
1148.89, 256, 0.5, 0.8, 0.8, 560, 263, 297
1151.92, 256, 0.5, 1.0, 1.0, 626, 313, 313
1154.99, 256, 0.5, 1.0, 1.0, 618, 309, 309
1158.06, 256, 0.5, 1.0, 1.0, 618, 309, 309
1161.07, 256, 0.5, 1.0, 1.0, 614, 307, 307
1164.12, 256, 0.5, 1.0, 1.0, 622, 311, 311
1167.15, 256, 1.0, 0.0, 0.0, 890, 445, 445
1170.18, 256, 1.0, 0.0, 0.0, 892, 446, 446
1173.19, 256, 1.0, 0.0, 0.0, 896, 448, 448
1176.20, 256, 1.0, 0.0, 0.0, 894, 447, 447
1179.21, 256, 1.0, 0.0, 0.0, 898, 449, 449
1182.28, 256, 1.0, 0.2, 0.2, 557, 277, 280
1185.38, 256, 1.0, 0.2, 0.2, 532, 266, 266
1188.44, 256, 1.0, 0.2, 0.2, 506, 254, 252
1191.49, 256, 1.0, 0.2, 0.2, 518, 262, 256
1194.54, 256, 1.0, 0.2, 0.2, 559, 281, 278
1197.58, 256, 1.0, 0.4, 0.4, 478, 238, 240
1200.66, 256, 1.0, 0.4, 0.4, 480, 237, 243
1203.74, 256, 1.0, 0.4, 0.4, 448, 227, 221
1206.83, 256, 1.0, 0.4, 0.4, 470, 234, 236
1209.87, 256, 1.0, 0.4, 0.4, 461, 230, 231
1212.95, 256, 1.0, 0.5, 0.5, 467, 235, 232
1215.97, 256, 1.0, 0.5, 0.5, 472, 240, 232
1219.07, 256, 1.0, 0.5, 0.5, 459, 233, 226
1222.16, 256, 1.0, 0.5, 0.5, 469, 235, 234
1225.23, 256, 1.0, 0.5, 0.5, 456, 228, 228
1228.31, 256, 1.0, 0.6, 0.6, 487, 244, 243
1231.33, 256, 1.0, 0.6, 0.6, 487, 240, 247
1234.40, 256, 1.0, 0.6, 0.6, 484, 240, 244
1237.45, 256, 1.0, 0.6, 0.6, 484, 247, 237
1240.53, 256, 1.0, 0.6, 0.6, 487, 236, 251
1243.58, 256, 1.0, 0.8, 0.8, 561, 274, 287
1246.62, 256, 1.0, 0.8, 0.8, 552, 282, 270
1249.69, 256, 1.0, 0.8, 0.8, 558, 285, 273
1252.72, 256, 1.0, 0.8, 0.8, 545, 265, 280
1255.79, 256, 1.0, 0.8, 0.8, 559, 282, 277
1258.80, 256, 1.0, 1.0, 1.0, 613, 307, 306
1261.81, 256, 1.0, 1.0, 1.0, 614, 307, 307
1264.84, 256, 1.0, 1.0, 1.0, 611, 306, 305
1267.88, 256, 1.0, 1.0, 1.0, 608, 304, 304
1270.95, 256, 1.0, 1.0, 1.0, 602, 301, 301
1273.98, 512, 0.0, 0.0, 0.0, 1997, 923, 1074
1277.01, 512, 0.0, 0.0, 0.0, 2003, 1092, 911
1280.02, 512, 0.0, 0.0, 0.0, 2010, 982, 1028
1283.05, 512, 0.0, 0.0, 0.0, 2002, 1061, 941
1286.07, 512, 0.0, 0.0, 0.0, 2003, 1044, 959
1289.19, 512, 0.0, 0.2, 0.2, 930, 466, 464
1292.28, 512, 0.0, 0.2, 0.2, 957, 469, 488
1295.36, 512, 0.0, 0.2, 0.2, 878, 440, 438
1298.40, 512, 0.0, 0.2, 0.2, 841, 414, 427
1301.46, 512, 0.0, 0.2, 0.2, 940, 466, 474
1304.60, 512, 0.0, 0.4, 0.4, 704, 354, 350
1307.63, 512, 0.0, 0.4, 0.4, 692, 346, 346
1310.75, 512, 0.0, 0.4, 0.4, 709, 353, 356
1313.83, 512, 0.0, 0.4, 0.4, 730, 358, 372
1316.92, 512, 0.0, 0.4, 0.4, 719, 356, 363
1320.10, 512, 0.0, 0.5, 0.5, 682, 330, 352
1323.14, 512, 0.0, 0.5, 0.5, 694, 345, 349
1326.26, 512, 0.0, 0.5, 0.5, 674, 338, 336
1329.42, 512, 0.0, 0.5, 0.5, 674, 342, 332
1332.43, 512, 0.0, 0.5, 0.5, 696, 348, 348
1335.51, 512, 0.0, 0.6, 0.6, 685, 341, 344
1338.56, 512, 0.0, 0.6, 0.6, 675, 332, 343
1341.62, 512, 0.0, 0.6, 0.6, 656, 327, 329
1344.73, 512, 0.0, 0.6, 0.6, 614, 305, 309
1347.96, 512, 0.0, 0.6, 0.6, 598, 294, 304
1351.09, 512, 0.0, 0.8, 0.8, 613, 318, 295
1354.16, 512, 0.0, 0.8, 0.8, 674, 326, 348
1357.27, 512, 0.0, 0.8, 0.8, 676, 338, 338
1360.36, 512, 0.0, 0.8, 0.8, 632, 322, 310
1363.38, 512, 0.0, 0.8, 0.8, 679, 332, 347
1366.39, 512, 0.0, 1.0, 1.0, 632, 316, 316
1369.46, 512, 0.0, 1.0, 1.0, 650, 325, 325
1372.56, 512, 0.0, 1.0, 1.0, 644, 322, 322
1375.67, 512, 0.0, 1.0, 1.0, 644, 322, 322
1378.82, 512, 0.0, 1.0, 1.0, 634, 317, 317
1381.83, 512, 0.5, 0.0, 0.0, 2294, 1147, 1147
1384.85, 512, 0.5, 0.0, 0.0, 2313, 1156, 1157
1387.88, 512, 0.5, 0.0, 0.0, 2317, 1159, 1158
1390.89, 512, 0.5, 0.0, 0.0, 2324, 1163, 1161
1393.92, 512, 0.5, 0.0, 0.0, 2317, 1158, 1159
1397.13, 512, 0.5, 0.2, 0.2, 965, 467, 498
1400.22, 512, 0.5, 0.2, 0.2, 970, 485, 485
1403.26, 512, 0.5, 0.2, 0.2, 921, 461, 460
1406.30, 512, 0.5, 0.2, 0.2, 922, 460, 462
1409.53, 512, 0.5, 0.2, 0.2, 914, 465, 449
1412.57, 512, 0.5, 0.4, 0.4, 759, 381, 378
1415.64, 512, 0.5, 0.4, 0.4, 738, 363, 375
1418.70, 512, 0.5, 0.4, 0.4, 736, 361, 375
1421.92, 512, 0.5, 0.4, 0.4, 720, 357, 363
1425.01, 512, 0.5, 0.4, 0.4, 717, 362, 355
1428.07, 512, 0.5, 0.5, 0.5, 676, 343, 333
1431.15, 512, 0.5, 0.5, 0.5, 705, 357, 348
1434.26, 512, 0.5, 0.5, 0.5, 614, 309, 305
1437.31, 512, 0.5, 0.5, 0.5, 560, 279, 281
1440.43, 512, 0.5, 0.5, 0.5, 640, 321, 319
1443.56, 512, 0.5, 0.6, 0.6, 597, 293, 304
1446.69, 512, 0.5, 0.6, 0.6, 529, 257, 272
1449.77, 512, 0.5, 0.6, 0.6, 600, 292, 308
1452.91, 512, 0.5, 0.6, 0.6, 698, 348, 350
1456.01, 512, 0.5, 0.6, 0.6, 681, 338, 343
1459.14, 512, 0.5, 0.8, 0.8, 625, 303, 322
1462.26, 512, 0.5, 0.8, 0.8, 625, 321, 304
1465.40, 512, 0.5, 0.8, 0.8, 609, 291, 318
1468.51, 512, 0.5, 0.8, 0.8, 644, 306, 338
1471.64, 512, 0.5, 0.8, 0.8, 644, 325, 319
1474.76, 512, 0.5, 1.0, 1.0, 640, 320, 320
1477.76, 512, 0.5, 1.0, 1.0, 632, 316, 316
1480.90, 512, 0.5, 1.0, 1.0, 638, 319, 319
1484.05, 512, 0.5, 1.0, 1.0, 634, 317, 317
1487.17, 512, 0.5, 1.0, 1.0, 640, 320, 320
1490.20, 512, 1.0, 0.0, 0.0, 2347, 1174, 1173
1493.23, 512, 1.0, 0.0, 0.0, 2371, 1186, 1185
1496.27, 512, 1.0, 0.0, 0.0, 2368, 1184, 1184
1499.31, 512, 1.0, 0.0, 0.0, 2372, 1186, 1186
1502.35, 512, 1.0, 0.0, 0.0, 2371, 1186, 1185
1505.41, 512, 1.0, 0.2, 0.2, 939, 474, 465
1508.44, 512, 1.0, 0.2, 0.2, 893, 448, 445
1511.47, 512, 1.0, 0.2, 0.2, 892, 445, 447
1514.52, 512, 1.0, 0.2, 0.2, 919, 458, 461
1517.57, 512, 1.0, 0.2, 0.2, 886, 443, 443
1520.69, 512, 1.0, 0.4, 0.4, 741, 369, 372
1523.80, 512, 1.0, 0.4, 0.4, 773, 388, 385
1526.88, 512, 1.0, 0.4, 0.4, 746, 373, 373
1529.91, 512, 1.0, 0.4, 0.4, 728, 365, 363
1532.99, 512, 1.0, 0.4, 0.4, 751, 378, 373
1536.03, 512, 1.0, 0.5, 0.5, 707, 362, 345
1539.07, 512, 1.0, 0.5, 0.5, 725, 361, 364
1542.14, 512, 1.0, 0.5, 0.5, 720, 359, 361
1545.27, 512, 1.0, 0.5, 0.5, 699, 351, 348
1548.30, 512, 1.0, 0.5, 0.5, 694, 349, 345
1551.41, 512, 1.0, 0.6, 0.6, 693, 355, 338
1554.49, 512, 1.0, 0.6, 0.6, 704, 357, 347
1557.57, 512, 1.0, 0.6, 0.6, 670, 330, 340
1560.70, 512, 1.0, 0.6, 0.6, 665, 335, 330
1563.80, 512, 1.0, 0.6, 0.6, 682, 338, 344
1566.94, 512, 1.0, 0.8, 0.8, 660, 318, 342
1569.95, 512, 1.0, 0.8, 0.8, 630, 315, 315
1573.10, 512, 1.0, 0.8, 0.8, 636, 333, 303
1576.29, 512, 1.0, 0.8, 0.8, 645, 331, 314
1579.38, 512, 1.0, 0.8, 0.8, 652, 329, 323
1582.52, 512, 1.0, 1.0, 1.0, 638, 319, 319
1585.53, 512, 1.0, 1.0, 1.0, 629, 314, 315
1588.71, 512, 1.0, 1.0, 1.0, 628, 314, 314
1591.86, 512, 1.0, 1.0, 1.0, 634, 317, 317
1594.90, 512, 1.0, 1.0, 1.0, 624, 312, 312
