3.00, 4, 0.0, 0.0, 0.0, 158, 78, 80
6.01, 4, 0.0, 0.0, 0.0, 155, 80, 75
9.01, 4, 0.0, 0.0, 0.0, 156, 76, 80
12.02, 4, 0.0, 0.0, 0.0, 157, 76, 81
15.02, 4, 0.0, 0.0, 0.0, 150, 76, 74
18.04, 4, 0.0, 0.2, 0.2, 16, 8, 8
21.08, 4, 0.0, 0.2, 0.2, 16, 8, 8
24.11, 4, 0.0, 0.2, 0.2, 16, 8, 8
27.15, 4, 0.0, 0.2, 0.2, 17, 8, 9
30.17, 4, 0.0, 0.2, 0.2, 16, 8, 8
33.21, 4, 0.0, 0.4, 0.4, 10, 5, 5
36.24, 4, 0.0, 0.4, 0.4, 10, 5, 5
39.27, 4, 0.0, 0.4, 0.4, 10, 5, 5
42.30, 4, 0.0, 0.4, 0.4, 10, 5, 5
45.31, 4, 0.0, 0.4, 0.4, 10, 5, 5
48.35, 4, 0.0, 0.5, 0.5, 8, 4, 4
51.37, 4, 0.0, 0.5, 0.5, 8, 4, 4
54.42, 4, 0.0, 0.5, 0.5, 8, 4, 4
57.52, 4, 0.0, 0.5, 0.5, 8, 4, 4
60.55, 4, 0.0, 0.5, 0.5, 8, 4, 4
63.62, 4, 0.0, 0.6, 0.6, 7, 4, 3
66.67, 4, 0.0, 0.6, 0.6, 7, 4, 3
69.72, 4, 0.0, 0.6, 0.6, 7, 3, 4
72.78, 4, 0.0, 0.6, 0.6, 6, 3, 3
75.82, 4, 0.0, 0.6, 0.6, 6, 3, 3
78.91, 4, 0.0, 0.8, 0.8, 6, 3, 3
81.93, 4, 0.0, 0.8, 0.8, 6, 3, 3
85.01, 4, 0.0, 0.8, 0.8, 6, 3, 3
88.09, 4, 0.0, 0.8, 0.8, 6, 3, 3
91.17, 4, 0.0, 0.8, 0.8, 6, 3, 3
94.24, 4, 0.0, 1.0, 1.0, 6, 3, 3
97.42, 4, 0.0, 1.0, 1.0, 4, 2, 2
100.53, 4, 0.0, 1.0, 1.0, 2, 1, 1
103.60, 4, 0.0, 1.0, 1.0, 4, 2, 2
106.67, 4, 0.0, 1.0, 1.0, 6, 3, 3
109.68, 4, 0.5, 0.0, 0.0, 85, 43, 42
112.68, 4, 0.5, 0.0, 0.0, 85, 42, 43
115.69, 4, 0.5, 0.0, 0.0, 84, 42, 42
118.70, 4, 0.5, 0.0, 0.0, 84, 42, 42
121.70, 4, 0.5, 0.0, 0.0, 84, 42, 42
124.72, 4, 0.5, 0.2, 0.2, 16, 8, 8
127.72, 4, 0.5, 0.2, 0.2, 16, 8, 8
130.75, 4, 0.5, 0.2, 0.2, 16, 8, 8
133.77, 4, 0.5, 0.2, 0.2, 16, 8, 8
136.81, 4, 0.5, 0.2, 0.2, 17, 8, 9
139.84, 4, 0.5, 0.4, 0.4, 10, 5, 5
142.85, 4, 0.5, 0.4, 0.4, 10, 5, 5
145.88, 4, 0.5, 0.4, 0.4, 10, 5, 5
148.94, 4, 0.5, 0.4, 0.4, 10, 5, 5
151.99, 4, 0.5, 0.4, 0.4, 10, 5, 5
155.04, 4, 0.5, 0.5, 0.5, 8, 4, 4
158.11, 4, 0.5, 0.5, 0.5, 8, 4, 4
161.12, 4, 0.5, 0.5, 0.5, 8, 4, 4
164.14, 4, 0.5, 0.5, 0.5, 8, 4, 4
167.22, 4, 0.5, 0.5, 0.5, 8, 4, 4
170.26, 4, 0.5, 0.6, 0.6, 6, 3, 3
173.33, 4, 0.5, 0.6, 0.6, 6, 3, 3
176.39, 4, 0.5, 0.6, 0.6, 6, 3, 3
179.46, 4, 0.5, 0.6, 0.6, 6, 3, 3
182.54, 4, 0.5, 0.6, 0.6, 6, 3, 3
185.59, 4, 0.5, 0.8, 0.8, 6, 3, 3
188.66, 4, 0.5, 0.8, 0.8, 6, 3, 3
191.72, 4, 0.5, 0.8, 0.8, 6, 3, 3
194.78, 4, 0.5, 0.8, 0.8, 6, 3, 3
197.85, 4, 0.5, 0.8, 0.8, 6, 3, 3
200.92, 4, 0.5, 1.0, 1.0, 6, 3, 3
203.98, 4, 0.5, 1.0, 1.0, 6, 3, 3
207.07, 4, 0.5, 1.0, 1.0, 6, 3, 3
210.17, 4, 0.5, 1.0, 1.0, 6, 3, 3
213.23, 4, 0.5, 1.0, 1.0, 6, 3, 3
216.24, 4, 1.0, 0.0, 0.0, 92, 46, 46
219.24, 4, 1.0, 0.0, 0.0, 91, 45, 46
222.25, 4, 1.0, 0.0, 0.0, 92, 46, 46
225.26, 4, 1.0, 0.0, 0.0, 91, 45, 46
228.26, 4, 1.0, 0.0, 0.0, 91, 45, 46
231.30, 4, 1.0, 0.2, 0.2, 16, 8, 8
234.32, 4, 1.0, 0.2, 0.2, 16, 8, 8
237.36, 4, 1.0, 0.2, 0.2, 16, 8, 8
240.40, 4, 1.0, 0.2, 0.2, 16, 8, 8
243.41, 4, 1.0, 0.2, 0.2, 16, 8, 8
246.46, 4, 1.0, 0.4, 0.4, 9, 4, 5
249.51, 4, 1.0, 0.4, 0.4, 10, 5, 5
252.58, 4, 1.0, 0.4, 0.4, 10, 5, 5
255.64, 4, 1.0, 0.4, 0.4, 10, 5, 5
258.68, 4, 1.0, 0.4, 0.4, 10, 5, 5
261.75, 4, 1.0, 0.5, 0.5, 8, 4, 4
264.75, 4, 1.0, 0.5, 0.5, 8, 4, 4
267.80, 4, 1.0, 0.5, 0.5, 8, 4, 4
270.82, 4, 1.0, 0.5, 0.5, 8, 4, 4
273.86, 4, 1.0, 0.5, 0.5, 8, 4, 4
276.88, 4, 1.0, 0.6, 0.6, 7, 3, 4
279.89, 4, 1.0, 0.6, 0.6, 7, 4, 3
282.92, 4, 1.0, 0.6, 0.6, 7, 3, 4
285.99, 4, 1.0, 0.6, 0.6, 6, 3, 3
289.03, 4, 1.0, 0.6, 0.6, 7, 3, 4
292.19, 4, 1.0, 0.8, 0.8, 2, 1, 1
295.33, 4, 1.0, 0.8, 0.8, 2, 1, 1
298.45, 4, 1.0, 0.8, 0.8, 2, 1, 1
301.55, 4, 1.0, 0.8, 0.8, 2, 1, 1
304.74, 4, 1.0, 0.8, 0.8, 2, 1, 1
307.89, 4, 1.0, 1.0, 1.0, 4, 2, 2
310.92, 4, 1.0, 1.0, 1.0, 2, 1, 1
314.18, 4, 1.0, 1.0, 1.0, 2, 1, 1
317.27, 4, 1.0, 1.0, 1.0, 2, 1, 1
320.33, 4, 1.0, 1.0, 1.0, 6, 3, 3
323.33, 8, 0.0, 0.0, 0.0, 254, 126, 128
326.33, 8, 0.0, 0.0, 0.0, 250, 128, 122
329.34, 8, 0.0, 0.0, 0.0, 256, 123, 133
332.34, 8, 0.0, 0.0, 0.0, 253, 125, 128
335.34, 8, 0.0, 0.0, 0.0, 258, 121, 137
338.36, 8, 0.0, 0.2, 0.2, 32, 16, 16
341.45, 8, 0.0, 0.2, 0.2, 27, 13, 14
344.53, 8, 0.0, 0.2, 0.2, 14, 7, 7
347.57, 8, 0.0, 0.2, 0.2, 24, 12, 12
350.62, 8, 0.0, 0.2, 0.2, 14, 7, 7
353.69, 8, 0.0, 0.4, 0.4, 6, 3, 3
356.82, 8, 0.0, 0.4, 0.4, 6, 3, 3
359.95, 8, 0.0, 0.4, 0.4, 6, 3, 3
363.13, 8, 0.0, 0.4, 0.4, 6, 3, 3
366.25, 8, 0.0, 0.4, 0.4, 6, 3, 3
369.30, 8, 0.0, 0.5, 0.5, 6, 3, 3
372.38, 8, 0.0, 0.5, 0.5, 6, 3, 3
375.49, 8, 0.0, 0.5, 0.5, 6, 3, 3
378.66, 8, 0.0, 0.5, 0.5, 5, 2, 3
381.87, 8, 0.0, 0.5, 0.5, 4, 2, 2
384.98, 8, 0.0, 0.6, 0.6, 4, 2, 2
388.13, 8, 0.0, 0.6, 0.6, 5, 3, 2
391.17, 8, 0.0, 0.6, 0.6, 4, 2, 2
394.29, 8, 0.0, 0.6, 0.6, 4, 2, 2
397.54, 8, 0.0, 0.6, 0.6, 4, 2, 2
400.76, 8, 0.0, 0.8, 0.8, 4, 2, 2
404.00, 8, 0.0, 0.8, 0.8, 4, 2, 2
407.21, 8, 0.0, 0.8, 0.8, 4, 2, 2
410.42, 8, 0.0, 0.8, 0.8, 4, 2, 2
413.68, 8, 0.0, 0.8, 0.8, 4, 2, 2
416.81, 8, 0.0, 1.0, 1.0, 3, 2, 1
420.00, 8, 0.0, 1.0, 1.0, 2, 1, 1
423.24, 8, 0.0, 1.0, 1.0, 2, 1, 1
426.49, 8, 0.0, 1.0, 1.0, 2, 1, 1
429.68, 8, 0.0, 1.0, 1.0, 2, 1, 1
432.69, 8, 0.5, 0.0, 0.0, 159, 79, 80
435.69, 8, 0.5, 0.0, 0.0, 159, 79, 80
438.70, 8, 0.5, 0.0, 0.0, 159, 79, 80
441.71, 8, 0.5, 0.0, 0.0, 159, 79, 80
444.71, 8, 0.5, 0.0, 0.0, 160, 80, 80
447.79, 8, 0.5, 0.2, 0.2, 14, 7, 7
450.83, 8, 0.5, 0.2, 0.2, 12, 6, 6
453.86, 8, 0.5, 0.2, 0.2, 12, 6, 6
456.89, 8, 0.5, 0.2, 0.2, 12, 6, 6
459.98, 8, 0.5, 0.2, 0.2, 12, 6, 6
463.10, 8, 0.5, 0.4, 0.4, 6, 3, 3
466.16, 8, 0.5, 0.4, 0.4, 8, 4, 4
469.22, 8, 0.5, 0.4, 0.4, 8, 4, 4
472.39, 8, 0.5, 0.4, 0.4, 7, 3, 4
475.45, 8, 0.5, 0.4, 0.4, 6, 3, 3
478.59, 8, 0.5, 0.5, 0.5, 4, 2, 2
481.59, 8, 0.5, 0.5, 0.5, 6, 3, 3
484.68, 8, 0.5, 0.5, 0.5, 6, 3, 3
487.76, 8, 0.5, 0.5, 0.5, 6, 3, 3
490.86, 8, 0.5, 0.5, 0.5, 5, 3, 2
494.03, 8, 0.5, 0.6, 0.6, 4, 2, 2
497.12, 8, 0.5, 0.6, 0.6, 4, 2, 2
500.21, 8, 0.5, 0.6, 0.6, 4, 2, 2
503.31, 8, 0.5, 0.6, 0.6, 4, 2, 2
506.49, 8, 0.5, 0.6, 0.6, 6, 3, 3
509.51, 8, 0.5, 0.8, 0.8, 4, 2, 2
512.58, 8, 0.5, 0.8, 0.8, 4, 2, 2
515.78, 8, 0.5, 0.8, 0.8, 4, 2, 2
519.02, 8, 0.5, 0.8, 0.8, 4, 2, 2
522.33, 8, 0.5, 0.8, 0.8, 4, 2, 2
525.54, 8, 0.5, 1.0, 1.0, 2, 1, 1
528.74, 8, 0.5, 1.0, 1.0, 2, 1, 1
532.08, 8, 0.5, 1.0, 1.0, 2, 1, 1
535.32, 8, 0.5, 1.0, 1.0, 2, 1, 1
538.58, 8, 0.5, 1.0, 1.0, 4, 2, 2
541.58, 8, 1.0, 0.0, 0.0, 171, 85, 86
544.58, 8, 1.0, 0.0, 0.0, 172, 86, 86
547.59, 8, 1.0, 0.0, 0.0, 170, 85, 85
550.60, 8, 1.0, 0.0, 0.0, 172, 86, 86
553.61, 8, 1.0, 0.0, 0.0, 171, 85, 86
556.66, 8, 1.0, 0.2, 0.2, 14, 7, 7
559.70, 8, 1.0, 0.2, 0.2, 13, 7, 6
562.74, 8, 1.0, 0.2, 0.2, 12, 6, 6
565.81, 8, 1.0, 0.2, 0.2, 12, 6, 6
568.85, 8, 1.0, 0.2, 0.2, 12, 6, 6
571.88, 8, 1.0, 0.4, 0.4, 6, 3, 3
575.03, 8, 1.0, 0.4, 0.4, 6, 3, 3
578.04, 8, 1.0, 0.4, 0.4, 6, 3, 3
581.18, 8, 1.0, 0.4, 0.4, 6, 3, 3
584.23, 8, 1.0, 0.4, 0.4, 8, 4, 4
587.37, 8, 1.0, 0.5, 0.5, 6, 3, 3
590.50, 8, 1.0, 0.5, 0.5, 5, 3, 2
593.68, 8, 1.0, 0.5, 0.5, 6, 3, 3
596.80, 8, 1.0, 0.5, 0.5, 7, 3, 4
599.91, 8, 1.0, 0.5, 0.5, 6, 3, 3
603.08, 8, 1.0, 0.6, 0.6, 4, 2, 2
606.28, 8, 1.0, 0.6, 0.6, 4, 2, 2
609.55, 8, 1.0, 0.6, 0.6, 4, 2, 2
612.68, 8, 1.0, 0.6, 0.6, 4, 2, 2
615.93, 8, 1.0, 0.6, 0.6, 4, 2, 2
619.01, 8, 1.0, 0.8, 0.8, 5, 2, 3
622.26, 8, 1.0, 0.8, 0.8, 4, 2, 2
625.39, 8, 1.0, 0.8, 0.8, 3, 2, 1
628.51, 8, 1.0, 0.8, 0.8, 4, 2, 2
631.58, 8, 1.0, 0.8, 0.8, 4, 2, 2
634.90, 8, 1.0, 1.0, 1.0, 2, 1, 1
637.98, 8, 1.0, 1.0, 1.0, 4, 2, 2
641.18, 8, 1.0, 1.0, 1.0, 3, 1, 2
644.47, 8, 1.0, 1.0, 1.0, 2, 1, 1
647.73, 8, 1.0, 1.0, 1.0, 2, 1, 1
650.75, 128, 0.0, 0.0, 0.0, 911, 385, 526
653.76, 128, 0.0, 0.0, 0.0, 893, 407, 486
656.78, 128, 0.0, 0.0, 0.0, 965, 418, 547
659.80, 128, 0.0, 0.0, 0.0, 901, 401, 500
662.81, 128, 0.0, 0.0, 0.0, 901, 403, 498
665.93, 128, 0.0, 0.2, 0.2, 151, 75, 76
669.02, 128, 0.0, 0.2, 0.2, 150, 74, 76
672.15, 128, 0.0, 0.2, 0.2, 175, 87, 88
675.23, 128, 0.0, 0.2, 0.2, 154, 77, 77
678.39, 128, 0.0, 0.2, 0.2, 158, 79, 79
681.50, 128, 0.0, 0.4, 0.4, 88, 44, 44
684.61, 128, 0.0, 0.4, 0.4, 88, 44, 44
687.74, 128, 0.0, 0.4, 0.4, 92, 45, 47
690.82, 128, 0.0, 0.4, 0.4, 88, 44, 44
693.96, 128, 0.0, 0.4, 0.4, 94, 47, 47
697.25, 128, 0.0, 0.5, 0.5, 75, 37, 38
700.41, 128, 0.0, 0.5, 0.5, 78, 39, 39
703.45, 128, 0.0, 0.5, 0.5, 73, 36, 37
706.57, 128, 0.0, 0.5, 0.5, 72, 36, 36
709.77, 128, 0.0, 0.5, 0.5, 78, 39, 39
713.04, 128, 0.0, 0.6, 0.6, 68, 34, 34
716.20, 128, 0.0, 0.6, 0.6, 62, 31, 31
719.30, 128, 0.0, 0.6, 0.6, 72, 36, 36
722.46, 128, 0.0, 0.6, 0.6, 63, 31, 32
725.63, 128, 0.0, 0.6, 0.6, 68, 35, 33
729.00, 128, 0.0, 0.8, 0.8, 58, 29, 29
732.44, 128, 0.0, 0.8, 0.8, 50, 25, 25
735.47, 128, 0.0, 0.8, 0.8, 56, 28, 28
738.88, 128, 0.0, 0.8, 0.8, 88, 44, 44
741.90, 128, 0.0, 0.8, 0.8, 48, 24, 24
744.95, 128, 0.0, 1.0, 1.0, 56, 28, 28
747.98, 128, 0.0, 1.0, 1.0, 56, 28, 28
751.19, 128, 0.0, 1.0, 1.0, 54, 27, 27
754.72, 128, 0.0, 1.0, 1.0, 49, 25, 24
757.78, 128, 0.0, 1.0, 1.0, 56, 28, 28
760.80, 128, 0.5, 0.0, 0.0, 759, 378, 381
763.83, 128, 0.5, 0.0, 0.0, 759, 379, 380
766.84, 128, 0.5, 0.0, 0.0, 763, 381, 382
769.86, 128, 0.5, 0.0, 0.0, 762, 380, 382
772.88, 128, 0.5, 0.0, 0.0, 765, 381, 384
775.98, 128, 0.5, 0.2, 0.2, 152, 76, 76
779.01, 128, 0.5, 0.2, 0.2, 256, 128, 128
782.13, 128, 0.5, 0.2, 0.2, 168, 84, 84
785.17, 128, 0.5, 0.2, 0.2, 156, 78, 78
788.28, 128, 0.5, 0.2, 0.2, 169, 84, 85
791.48, 128, 0.5, 0.4, 0.4, 85, 43, 42
794.52, 128, 0.5, 0.4, 0.4, 90, 45, 45
797.67, 128, 0.5, 0.4, 0.4, 94, 47, 47
800.71, 128, 0.5, 0.4, 0.4, 138, 69, 69
803.77, 128, 0.5, 0.4, 0.4, 114, 57, 57
806.97, 128, 0.5, 0.5, 0.5, 101, 50, 51
810.23, 128, 0.5, 0.5, 0.5, 76, 38, 38
813.40, 128, 0.5, 0.5, 0.5, 132, 67, 65
816.64, 128, 0.5, 0.5, 0.5, 76, 38, 38
819.74, 128, 0.5, 0.5, 0.5, 80, 40, 40
822.91, 128, 0.5, 0.6, 0.6, 100, 49, 51
825.96, 128, 0.5, 0.6, 0.6, 73, 36, 37
829.11, 128, 0.5, 0.6, 0.6, 71, 35, 36
832.42, 128, 0.5, 0.6, 0.6, 68, 34, 34
835.47, 128, 0.5, 0.6, 0.6, 81, 40, 41
838.50, 128, 0.5, 0.8, 0.8, 57, 28, 29
841.63, 128, 0.5, 0.8, 0.8, 55, 28, 27
844.81, 128, 0.5, 0.8, 0.8, 62, 31, 31
848.02, 128, 0.5, 0.8, 0.8, 62, 31, 31
851.18, 128, 0.5, 0.8, 0.8, 55, 28, 27
854.55, 128, 0.5, 1.0, 1.0, 44, 22, 22
857.66, 128, 0.5, 1.0, 1.0, 64, 32, 32
860.89, 128, 0.5, 1.0, 1.0, 61, 30, 31
864.24, 128, 0.5, 1.0, 1.0, 52, 26, 26
867.57, 128, 0.5, 1.0, 1.0, 66, 33, 33
870.60, 128, 1.0, 0.0, 0.0, 768, 384, 384
873.62, 128, 1.0, 0.0, 0.0, 769, 385, 384
876.62, 128, 1.0, 0.0, 0.0, 772, 386, 386
879.64, 128, 1.0, 0.0, 0.0, 771, 386, 385
882.65, 128, 1.0, 0.0, 0.0, 772, 386, 386
885.69, 128, 1.0, 0.2, 0.2, 164, 82, 82
888.79, 128, 1.0, 0.2, 0.2, 153, 76, 77
891.87, 128, 1.0, 0.2, 0.2, 154, 77, 77
894.89, 128, 1.0, 0.2, 0.2, 156, 78, 78
897.92, 128, 1.0, 0.2, 0.2, 164, 82, 82
900.98, 128, 1.0, 0.4, 0.4, 89, 45, 44
904.04, 128, 1.0, 0.4, 0.4, 122, 61, 61
907.08, 128, 1.0, 0.4, 0.4, 107, 54, 53
910.11, 128, 1.0, 0.4, 0.4, 90, 45, 45
913.31, 128, 1.0, 0.4, 0.4, 86, 43, 43
916.45, 128, 1.0, 0.5, 0.5, 78, 39, 39
919.67, 128, 1.0, 0.5, 0.5, 74, 38, 36
922.74, 128, 1.0, 0.5, 0.5, 80, 40, 40
925.82, 128, 1.0, 0.5, 0.5, 80, 40, 40
928.86, 128, 1.0, 0.5, 0.5, 82, 41, 41
932.16, 128, 1.0, 0.6, 0.6, 68, 34, 34
935.37, 128, 1.0, 0.6, 0.6, 83, 41, 42
938.62, 128, 1.0, 0.6, 0.6, 60, 30, 30
941.82, 128, 1.0, 0.6, 0.6, 71, 36, 35
944.88, 128, 1.0, 0.6, 0.6, 64, 32, 32
948.06, 128, 1.0, 0.8, 0.8, 54, 27, 27
951.44, 128, 1.0, 0.8, 0.8, 50, 25, 25
954.77, 128, 1.0, 0.8, 0.8, 52, 26, 26
957.91, 128, 1.0, 0.8, 0.8, 55, 27, 28
961.29, 128, 1.0, 0.8, 0.8, 51, 25, 26
964.58, 128, 1.0, 1.0, 1.0, 44, 22, 22
967.80, 128, 1.0, 1.0, 1.0, 46, 23, 23
971.10, 128, 1.0, 1.0, 1.0, 44, 22, 22
974.48, 128, 1.0, 1.0, 1.0, 44, 22, 22
977.91, 128, 1.0, 1.0, 1.0, 50, 25, 25
980.93, 256, 0.0, 0.0, 0.0, 1029, 538, 491
983.94, 256, 0.0, 0.0, 0.0, 1012, 515, 497
986.97, 256, 0.0, 0.0, 0.0, 1072, 528, 544
989.99, 256, 0.0, 0.0, 0.0, 1145, 557, 588
993.00, 256, 0.0, 0.0, 0.0, 1189, 565, 624
996.15, 256, 0.0, 0.2, 0.2, 285, 143, 142
999.37, 256, 0.0, 0.2, 0.2, 249, 124, 125
1002.56, 256, 0.0, 0.2, 0.2, 266, 133, 133
1005.72, 256, 0.0, 0.2, 0.2, 253, 127, 126
1008.89, 256, 0.0, 0.2, 0.2, 236, 118, 118
1011.92, 256, 0.0, 0.4, 0.4, 165, 82, 83
1015.00, 256, 0.0, 0.4, 0.4, 162, 81, 81
1018.14, 256, 0.0, 0.4, 0.4, 143, 71, 72
1021.24, 256, 0.0, 0.4, 0.4, 144, 72, 72
1024.44, 256, 0.0, 0.4, 0.4, 156, 78, 78
1027.64, 256, 0.0, 0.5, 0.5, 124, 62, 62
1030.82, 256, 0.0, 0.5, 0.5, 141, 70, 71
1033.90, 256, 0.0, 0.5, 0.5, 146, 73, 73
1037.06, 256, 0.0, 0.5, 0.5, 126, 63, 63
1040.31, 256, 0.0, 0.5, 0.5, 122, 61, 61
1043.74, 256, 0.0, 0.6, 0.6, 101, 50, 51
1047.07, 256, 0.0, 0.6, 0.6, 104, 52, 52
1050.50, 256, 0.0, 0.6, 0.6, 116, 58, 58
1053.58, 256, 0.0, 0.6, 0.6, 113, 57, 56
1056.85, 256, 0.0, 0.6, 0.6, 122, 61, 61
1059.85, 256, 0.0, 0.8, 0.8, 98, 49, 49
1063.23, 256, 0.0, 0.8, 0.8, 88, 44, 44
1066.59, 256, 0.0, 0.8, 0.8, 89, 45, 44
1070.01, 256, 0.0, 0.8, 0.8, 87, 44, 43
1073.31, 256, 0.0, 0.8, 0.8, 90, 45, 45
1076.65, 256, 0.0, 1.0, 1.0, 88, 44, 44
1079.72, 256, 0.0, 1.0, 1.0, 96, 48, 48
1082.79, 256, 0.0, 1.0, 1.0, 80, 40, 40
1086.16, 256, 0.0, 1.0, 1.0, 88, 44, 44
1089.69, 256, 0.0, 1.0, 1.0, 84, 42, 42
1092.70, 256, 0.5, 0.0, 0.0, 1062, 531, 531
1095.70, 256, 0.5, 0.0, 0.0, 1064, 532, 532
1098.73, 256, 0.5, 0.0, 0.0, 1070, 533, 537
1101.75, 256, 0.5, 0.0, 0.0, 1070, 537, 533
1104.76, 256, 0.5, 0.0, 0.0, 1064, 532, 532
1107.92, 256, 0.5, 0.2, 0.2, 221, 110, 111
1111.11, 256, 0.5, 0.2, 0.2, 251, 125, 126
1114.30, 256, 0.5, 0.2, 0.2, 235, 117, 118
1117.41, 256, 0.5, 0.2, 0.2, 224, 112, 112
1120.57, 256, 0.5, 0.2, 0.2, 221, 110, 111
1123.77, 256, 0.5, 0.4, 0.4, 136, 66, 70
1126.94, 256, 0.5, 0.4, 0.4, 142, 71, 71
1130.19, 256, 0.5, 0.4, 0.4, 138, 69, 69
1133.27, 256, 0.5, 0.4, 0.4, 145, 72, 73
1136.51, 256, 0.5, 0.4, 0.4, 138, 69, 69
1139.91, 256, 0.5, 0.5, 0.5, 117, 59, 58
1143.00, 256, 0.5, 0.5, 0.5, 112, 56, 56
1146.07, 256, 0.5, 0.5, 0.5, 114, 57, 57
1149.42, 256, 0.5, 0.5, 0.5, 118, 59, 59
1152.77, 256, 0.5, 0.5, 0.5, 118, 59, 59
1156.17, 256, 0.5, 0.6, 0.6, 102, 51, 51
1159.42, 256, 0.5, 0.6, 0.6, 107, 54, 53
1162.76, 256, 0.5, 0.6, 0.6, 104, 52, 52
1166.18, 256, 0.5, 0.6, 0.6, 102, 51, 51
1169.53, 256, 0.5, 0.6, 0.6, 104, 52, 52
1172.87, 256, 0.5, 0.8, 0.8, 89, 44, 45
1176.09, 256, 0.5, 0.8, 0.8, 92, 46, 46
1179.49, 256, 0.5, 0.8, 0.8, 89, 44, 45
1182.78, 256, 0.5, 0.8, 0.8, 90, 45, 45
1186.16, 256, 0.5, 0.8, 0.8, 88, 44, 44
1189.73, 256, 0.5, 1.0, 1.0, 84, 42, 42
1193.29, 256, 0.5, 1.0, 1.0, 83, 41, 42
1196.86, 256, 0.5, 1.0, 1.0, 83, 41, 42
1200.41, 256, 0.5, 1.0, 1.0, 84, 42, 42
1203.99, 256, 0.5, 1.0, 1.0, 82, 41, 41
1207.03, 256, 1.0, 0.0, 0.0, 970, 485, 485
1210.07, 256, 1.0, 0.0, 0.0, 970, 485, 485
1213.10, 256, 1.0, 0.0, 0.0, 972, 486, 486
1216.14, 256, 1.0, 0.0, 0.0, 970, 485, 485
1219.19, 256, 1.0, 0.0, 0.0, 968, 484, 484
1222.33, 256, 1.0, 0.2, 0.2, 219, 111, 108
1225.47, 256, 1.0, 0.2, 0.2, 222, 111, 111
1228.60, 256, 1.0, 0.2, 0.2, 222, 111, 111
1231.80, 256, 1.0, 0.2, 0.2, 203, 102, 101
1234.86, 256, 1.0, 0.2, 0.2, 229, 115, 114
1238.21, 256, 1.0, 0.4, 0.4, 135, 68, 67
1241.55, 256, 1.0, 0.4, 0.4, 134, 67, 67
1244.82, 256, 1.0, 0.4, 0.4, 136, 68, 68
1248.06, 256, 1.0, 0.4, 0.4, 139, 70, 69
1251.32, 256, 1.0, 0.4, 0.4, 138, 69, 69
1254.62, 256, 1.0, 0.5, 0.5, 120, 60, 60
1258.03, 256, 1.0, 0.5, 0.5, 116, 58, 58
1261.50, 256, 1.0, 0.5, 0.5, 115, 57, 58
1264.92, 256, 1.0, 0.5, 0.5, 116, 58, 58
1268.28, 256, 1.0, 0.5, 0.5, 118, 59, 59
1271.61, 256, 1.0, 0.6, 0.6, 104, 52, 52
1275.04, 256, 1.0, 0.6, 0.6, 101, 50, 51
1278.33, 256, 1.0, 0.6, 0.6, 106, 53, 53
1281.67, 256, 1.0, 0.6, 0.6, 104, 52, 52
1285.14, 256, 1.0, 0.6, 0.6, 100, 50, 50
1288.48, 256, 1.0, 0.8, 0.8, 89, 45, 44
1291.80, 256, 1.0, 0.8, 0.8, 90, 45, 45
1295.13, 256, 1.0, 0.8, 0.8, 90, 45, 45
1298.48, 256, 1.0, 0.8, 0.8, 88, 44, 44
1301.83, 256, 1.0, 0.8, 0.8, 88, 44, 44
1305.40, 256, 1.0, 1.0, 1.0, 84, 42, 42
1308.95, 256, 1.0, 1.0, 1.0, 84, 42, 42
1312.54, 256, 1.0, 1.0, 1.0, 83, 42, 41
1316.14, 256, 1.0, 1.0, 1.0, 82, 41, 41
1319.15, 256, 1.0, 1.0, 1.0, 82, 41, 41
1322.17, 512, 0.0, 0.0, 0.0, 2271, 1110, 1161
1325.20, 512, 0.0, 0.0, 0.0, 2278, 1109, 1169
1328.23, 512, 0.0, 0.0, 0.0, 2271, 1075, 1196
1331.26, 512, 0.0, 0.0, 0.0, 2274, 1072, 1202
1334.29, 512, 0.0, 0.0, 0.0, 2283, 1176, 1107
1337.46, 512, 0.0, 0.2, 0.2, 472, 236, 236
1340.51, 512, 0.0, 0.2, 0.2, 460, 229, 231
1343.60, 512, 0.0, 0.2, 0.2, 454, 226, 228
1346.82, 512, 0.0, 0.2, 0.2, 466, 234, 232
1349.99, 512, 0.0, 0.2, 0.2, 467, 237, 230
1353.28, 512, 0.0, 0.4, 0.4, 274, 138, 136
1356.43, 512, 0.0, 0.4, 0.4, 287, 145, 142
1359.63, 512, 0.0, 0.4, 0.4, 281, 140, 141
1362.96, 512, 0.0, 0.4, 0.4, 270, 135, 135
1366.00, 512, 0.0, 0.4, 0.4, 296, 148, 148
1369.04, 512, 0.0, 0.5, 0.5, 230, 115, 115
1372.30, 512, 0.0, 0.5, 0.5, 245, 123, 122
1375.70, 512, 0.0, 0.5, 0.5, 235, 118, 117
1378.97, 512, 0.0, 0.5, 0.5, 238, 122, 116
1381.98, 512, 0.0, 0.5, 0.5, 232, 116, 116
1385.26, 512, 0.0, 0.6, 0.6, 213, 106, 107
1388.61, 512, 0.0, 0.6, 0.6, 208, 104, 104
1391.74, 512, 0.0, 0.6, 0.6, 223, 112, 111
1395.12, 512, 0.0, 0.6, 0.6, 207, 104, 103
1398.60, 512, 0.0, 0.6, 0.6, 200, 100, 100
1401.77, 512, 0.0, 0.8, 0.8, 189, 94, 95
1405.17, 512, 0.0, 0.8, 0.8, 176, 88, 88
1408.53, 512, 0.0, 0.8, 0.8, 178, 89, 89
1411.97, 512, 0.0, 0.8, 0.8, 175, 88, 87
1415.43, 512, 0.0, 0.8, 0.8, 173, 87, 86
1418.47, 512, 0.0, 1.0, 1.0, 164, 82, 82
1421.83, 512, 0.0, 1.0, 1.0, 178, 89, 89
1425.24, 512, 0.0, 1.0, 1.0, 174, 87, 87
1428.82, 512, 0.0, 1.0, 1.0, 166, 83, 83
1431.88, 512, 0.0, 1.0, 1.0, 162, 81, 81
1434.91, 512, 0.5, 0.0, 0.0, 2411, 1205, 1206
1437.93, 512, 0.5, 0.0, 0.0, 2418, 1208, 1210
1440.95, 512, 0.5, 0.0, 0.0, 2417, 1209, 1208
1443.97, 512, 0.5, 0.0, 0.0, 2418, 1210, 1208
1446.99, 512, 0.5, 0.0, 0.0, 2421, 1209, 1212
1450.21, 512, 0.5, 0.2, 0.2, 436, 217, 219
1453.29, 512, 0.5, 0.2, 0.2, 487, 243, 244
1456.48, 512, 0.5, 0.2, 0.2, 440, 221, 219
1459.68, 512, 0.5, 0.2, 0.2, 467, 234, 233
1462.75, 512, 0.5, 0.2, 0.2, 459, 228, 231
1466.01, 512, 0.5, 0.4, 0.4, 276, 138, 138
1469.20, 512, 0.5, 0.4, 0.4, 282, 141, 141
1472.47, 512, 0.5, 0.4, 0.4, 276, 139, 137
1475.76, 512, 0.5, 0.4, 0.4, 272, 136, 136
1478.95, 512, 0.5, 0.4, 0.4, 281, 141, 140
1482.25, 512, 0.5, 0.5, 0.5, 237, 116, 121
1485.29, 512, 0.5, 0.5, 0.5, 231, 116, 115
1488.60, 512, 0.5, 0.5, 0.5, 241, 120, 121
1491.94, 512, 0.5, 0.5, 0.5, 238, 119, 119
1495.01, 512, 0.5, 0.5, 0.5, 228, 114, 114
1498.38, 512, 0.5, 0.6, 0.6, 207, 104, 103
1501.62, 512, 0.5, 0.6, 0.6, 215, 108, 107
1504.86, 512, 0.5, 0.6, 0.6, 216, 108, 108
1508.13, 512, 0.5, 0.6, 0.6, 213, 106, 107
1511.39, 512, 0.5, 0.6, 0.6, 215, 108, 107
1514.68, 512, 0.5, 0.8, 0.8, 182, 91, 91
1517.90, 512, 0.5, 0.8, 0.8, 186, 93, 93
1521.23, 512, 0.5, 0.8, 0.8, 180, 90, 90
1524.57, 512, 0.5, 0.8, 0.8, 180, 90, 90
1527.81, 512, 0.5, 0.8, 0.8, 184, 92, 92
1531.40, 512, 0.5, 1.0, 1.0, 166, 83, 83
1534.41, 512, 0.5, 1.0, 1.0, 166, 83, 83
1537.99, 512, 0.5, 1.0, 1.0, 168, 84, 84
1541.53, 512, 0.5, 1.0, 1.0, 168, 84, 84
1545.09, 512, 0.5, 1.0, 1.0, 167, 83, 84
1548.13, 512, 1.0, 0.0, 0.0, 2406, 1203, 1203
1551.15, 512, 1.0, 0.0, 0.0, 2418, 1209, 1209
1554.16, 512, 1.0, 0.0, 0.0, 2420, 1210, 1210
1557.17, 512, 1.0, 0.0, 0.0, 2426, 1213, 1213
1560.18, 512, 1.0, 0.0, 0.0, 2426, 1213, 1213
1563.31, 512, 1.0, 0.2, 0.2, 470, 231, 239
1566.43, 512, 1.0, 0.2, 0.2, 450, 224, 226
1569.53, 512, 1.0, 0.2, 0.2, 473, 231, 242
1572.70, 512, 1.0, 0.2, 0.2, 440, 220, 220
1575.87, 512, 1.0, 0.2, 0.2, 444, 223, 221
1579.14, 512, 1.0, 0.4, 0.4, 276, 139, 137
1582.44, 512, 1.0, 0.4, 0.4, 273, 136, 137
1585.62, 512, 1.0, 0.4, 0.4, 282, 141, 141
1588.93, 512, 1.0, 0.4, 0.4, 272, 136, 136
1592.26, 512, 1.0, 0.4, 0.4, 270, 135, 135
1595.66, 512, 1.0, 0.5, 0.5, 235, 118, 117
1599.04, 512, 1.0, 0.5, 0.5, 236, 118, 118
1602.35, 512, 1.0, 0.5, 0.5, 241, 121, 120
1605.77, 512, 1.0, 0.5, 0.5, 234, 117, 117
1609.09, 512, 1.0, 0.5, 0.5, 235, 115, 120
1612.44, 512, 1.0, 0.6, 0.6, 209, 104, 105
1615.83, 512, 1.0, 0.6, 0.6, 207, 103, 104
1619.16, 512, 1.0, 0.6, 0.6, 210, 105, 105
1622.44, 512, 1.0, 0.6, 0.6, 213, 106, 107
1625.73, 512, 1.0, 0.6, 0.6, 212, 106, 106
1629.04, 512, 1.0, 0.8, 0.8, 181, 90, 91
1632.42, 512, 1.0, 0.8, 0.8, 177, 88, 89
1635.73, 512, 1.0, 0.8, 0.8, 180, 90, 90
1639.01, 512, 1.0, 0.8, 0.8, 182, 91, 91
1642.30, 512, 1.0, 0.8, 0.8, 182, 91, 91
1645.86, 512, 1.0, 1.0, 1.0, 168, 84, 84
1649.41, 512, 1.0, 1.0, 1.0, 168, 84, 84
1652.96, 512, 1.0, 1.0, 1.0, 168, 84, 84
1656.51, 512, 1.0, 1.0, 1.0, 168, 84, 84
1660.09, 512, 1.0, 1.0, 1.0, 168, 84, 84
